NO ./textures/brick.xpm
SO ./textures/blue.xpm
WE ./textures/wood.xpm
EA ./textures/grey.xpm

F 100,0,100
C 0,0,0

1111111111111111111111111111111111111111111
10000000000000000001000000000000000000000001
10000000000000000000000100000000000000000001
10000000000000000010100000000000W0000000011
10000000000000000000000000000000000000000111
1111111111111111111111111111111111111111111111

