NO ./textures/brick.xpm
SO ./textures/blue.xpm
WE ./textures/wood.xpm
EA ./textures/grey.xpm

F 224,172,105
C 205,249,255





111111111    1111111111111111
100000001    1000000000000001
101100001    100001000001001
100000001111110000000N0010001
1011000001110000000010000101
10000000001100000111011110001
11110111111111011100000010001
11110111111111011101011111111
11000000110101011000001
10000000000000000000001111111
10000000000000001101010010001
11000000110101011111011110001
11110111111101011111011110001
111111111111111111111111111111

